1111111111111111111111111111111111111111111111111111111115555555555551155555555555511554200000355115555555555551155555555555511111111111111111111111111111111111111111111111111111111111111111111111
1111111111111111111111111111111111111111111155555555511111554000055111115555522551111111155005511111111550055111111115503551111111155055511111111550551111111115535511111111155555111111111111111111
1111111111111111111111111111111111111111111111155555511115555550055111155420000551111555555505511111555555055111115500550051111155000000511111550555555111115535511111111155555111111111111111111111
1111555555111111115500555551111155400000515555500055005150335050550551500000200525515500505000055155555000552551111155555500511111530000005111115555555551111111111111111111111111111111111111111111
1111111111111111111111111111111111111111111555555111111115500555551111150000005511111503352055111115550020551111111555405511111111555555111111111111111111111111111111111111111111111111111111111111
1111111111111111111111111111111111111111111155555555111111555003551111115502535511111155000055111111555050051111111552040511111115500055111111155555551111111111111111111111111111111111111111111111
1111111111111111111111111111111111111111111111555555551111115550355511111155500551111111502200511111115000005111111155250551111111553435511111115555555111111111111111111111111111111111111111111111
1111111111111111111111111111111111111111111155555555551111553333455511115002052055111150020020551111500550005511115555555555111111111111111111111111111111111111111111111111111111111111111111111111
1111111111111111555555555111115555400551111155302035511111550020555111115550555551111550200551111115000005511111153005555111111555555551111111111111111111111111111111111111111111111111111111111111
1111111111111111111111111111111111555551111555555005511115500033255111155024502051111555233000511115550055005111155555555551111111111111111111111111111111111111111111111111111111111111111111111111
1111111111111111111111111111111111111111111555555555111115500555551111155030035511111550305055111115500200551111155522555511111555045555111115555555551111111111111111111111111111111111111111111111
1111111111111111111111111111111111111111111155555555551111555500555511115555005555111155002220551111550333505511115505333055111155022245551111555500055511115555555555111111111111111111111111111111
1111111111111111111111111111111111111111111111111111111111115555555511111155503555111111555033051111115002003511111150005055111111552220551111115504555511111155555555111111111111111111111111111111
1111111111111111111111111111115555555511111155500555111111555020551111115503235511111155023205111111550323051111115555455511111155500551111111155005511111111550055111111115555551111111111111111111
1111111111111111111111111111111111111111111555555555511115550005555111150323240051111500232300511115550505555111115500055111111155555551111111111111111111111111111111111111111111111111111111111111
1111111111111111111111111111111111111111111155555555111111555005551111115553055511111155030555111111552325551111115423200511111150230005111111555005551111115555555511111111111111111111111111111111
1111111111111111111111111111111111111111111111555555551111115500055511111155062555111111506460051111115036000511111155000555111111550055511111115555555111111111111111111111111111111111111111111111
1111111111111111111111111111111111111111111115555555111111155043551111111502260511111115005305111111150000051111111502500511111115500355111111155555551111111111111111111111111111111111111111111111
1111111111111111111111111111111155555511111155550055511111500020055111115006660551111150030305511111550606005111115556660051111155502055511111555040555111111555555511111111111111111111111111111111
1111111111111111111111111111111111111111111555555555511115000555005511150200000455111552666662551115023333320511150005000005111555555550051111111111555511111111111111111111111111111111111111111111